0000000000
0111011110
0111111010
0110111110
0111111110
0100111110
0111111110
0101110110
0111111110
0000000000
